type octile
height 7
width 31
map
TTTTTTTTTTTTTTTTTTTTTTTTTTTTTTT
T....NNNNNNNNNN.NNNNNNNNNN....T
T....SSSSSSSSSS.SSSSSSSSSS....T
T.............................T
T....NNNNNNNNNN.NNNNNNNNNN....T
T....SSSSSSSSSS.SSSSSSSSSS....T
TTTTTTTTTTTTTTTTTTTTTTTTTTTTTTT
