type octile
height 7
width 52
map
TTTTTTTTTTTTTTTTTTTTTTTTTTTTTTTTTTTTTTTTTTTTTTTTTTTT
T........NNNNNNNNNN.NNNNNNNNNN.NNNNNNNNNN..........T
T........SSSSSSSSSS.SSSSSSSSSS.SSSSSSSSSS..........T
T..................................................T
T........NNNNNNNNNN.NNNNNNNNNN.NNNNNNNNNN..........T
T........SSSSSSSSSS.SSSSSSSSSS.SSSSSSSSSS..........T
TTTTTTTTTTTTTTTTTTTTTTTTTTTTTTTTTTTTTTTTTTTTTTTTTTTT
